1
........................................|
........................................|
........................................|
........................................|
........................................|
........................................|
...........................wwwww........|
...........................w...w........|
...........................w.e.w........|
...........................wwwww........|
...........................w...w........|
...........................w...w........|
...........................w...w........|
...........................w...w........|
.......................wwwww...wwwww....|
.......................w...wwwww...w....|
.......................w...w...w...w....|
.......................w...w...w.e.w....|
.......................w...w...wwwww....|
.......................w...w...w...w....|
.......................w...w...w...w....|
.......................w...w.e.w...w....|
2
........................................|
........................................|
.......wwwwwww..........................|
.......w.....w..........................|
.......w.....w..........................|
.......w..e..w..........................|
.......WWwwwWW..........................|
.....sssss.sssss........................|
.....ggg.....ggg........................|
........................................|
........................................|
..............................ssss......|
............................ssssSSSS....|
..........................ssssssssssss..|
..........................s..........s..|
..........................s..........s..|
..........................s.e........s..|
..........................sssss..sssss..|
..........................s...w..w...s..|
..........................sw..w..w...s..|
..........................sWw.w..w.e.s..|
..........................swwWWwwWWwws..|
3
........................................|
........................................|
........................................|
........................................|
........................................|
.............................m..e...m...|
.............................mmmmmmmm...|
.............................mm....mm...|
.............................m......m...|
.............................m......m...|
.............................m......m...|
...........mmmmmmmmmm........mmmmmmmm...|
...........mmm....mmm........mm....mm...|
...........mm.....wmm........m......m...|
...........mm...wWwmm........m......m...|
...........mm..wWwWmm........m.W....m...|
...........mmmmmmmmmm........mmmmmmmm...|
...........mmm....mmm........mm....mm...|
...........mm......mm........m......m...|
..........smm......mm........m......m...|
.........Ssmm......mm........m...e..m...|
........sSsmmWWwwWWmm.....e..mWWwwWWm...|
4
........................................|
........................................|
........................................|
........................................|
........................................|
...................................s....|
..................................sss...|
.................................ss.ss..|
.................s..............ss.e.ss.|
................sss..............ggggg..|
...............sssss....................|
..............ss...ss...................|
.............ss..e..ss..................|
..............ggggggg...................|
........................................|
........................................|
.................................s......|
................................sss.....|
...............................sssss....|
..............................ss...ss...|
.............................ss.....ss..|
............................sss..e..sss.|
5
........................................|
........................................|
........................................|
........................................|
........................................|
........................................|
........................................|
.....................mm.................|
....................mmmm................|
...................mmmmmm...............|
..................mmm..mmm..............|
.................mmm....mmm.............|
................mmm......mmm............|
...............mmmmmmmmmmmmmm...........|
..............mmm..........mmm..........|
.............mmm..........e.mmm.........|
............mmmmmm........mmmmmm........|
...........mmmmmmmm......mmmmmmmm.......|
..........mmm....mmm....mmm....mmm......|
.........mmm......mmme.mmm......mmm.....|
........mmm....e...mmmmmm....e...mmm....|
.......MMMmmmMMMmmmMMMmmmMMMmmmMMMmmm...|